3333333333331133333333333333
3000000000000000000000000003
3000000000000000000000000003
3003333300033333000333330003
3003000300030003000300030003
3003000300030003000333330003
3003000300030003000300000003
3003333300033333000300000003
3000000000000000000000000003
3000000000000000000000000003
3000000000000000000000000003
3000000000000000000000000003
3000000000000000000000000003
1000000000000000000000000001
1000000000000000000000000001
3330000000000330000000000333
3330000000000330000000000333
3000000000000000000000000003
3000000000000000000000000003
3000033003300000033003300003
3000033003300000033003300003
3000000000000000000000000003
3000000000000000000000000003
3000000000000000000000000003
3000000000000000000000000003
3000000000000000000000000003
3000000000000000000000000003
3333333333331133333333333333