3333333333333333333333333333
3000000000000000000000000003
3000000000000000000000000003
3000000000000000000000000003
3000000333333333333330000003
3000000000000330000000000003
3000000000000330000000000003
3000000000000330000000000003
3000000333333333333330000003
3000000000000000000000000003
3000000000000000000000000003
3000000000000000000000000003
3000000000000000000000000003
3000000000000000000000000001
3000000000000000000000000001
3330000000000330000000000333
3330000000000330000000000333
3000000000000000000000000003
3000000000000000000000000003
3000033003300000033003300003
3000033003300000033003300003
3000000000000000000000000003
3000000000000000000000000003
3000000000000000000000000003
3000000000000000000000000003
3000000000000000000000000003
3000000000000000000000000003
3333333333331133333333333333