3333333333333333333333333333
3000000000000000000000000003
3000000000000000000000000003
3000000000000000000000000003
3000333330000000000333330003
3000300000000000000000030003
3000300000000000000000030003
3000300000000000000000030003
3000000000000000000000000003
3000000000000000000000000003
3000000003333333333000000003
3000000000000000000000000003
3000000000000000000000000003
1000000000000000000000000001
1000000000000000000000000001
3330000000000330000000000333
3330000000000330000000000333
3000000000000000000000000003
3000000000000000000000000003
3000033003300000033003300003
3000033003300000033003300003
3000000000000000000000000003
3000000000000000000000000003
3000000000000000000000000003
3000000000000000000000000003
3000000000000000000000000003
3000000000000000000000000003
3333333333331133333333333333